WWWWWWWWWW
W##d#W##G#W
W#W###WW#W
W#G##W#W#W
W#WWWW#W#W
W##E#G#W#W
WWWWWW#W#W
W###GGGGGW
WPW#W#W#TW
WWWWWWWWWW