WWWWWWWWWW
WPGGGWT##W
W#WGW#WW#W
W#G##E#W#W
W#WWWW#W#W
W##G###W#W
WWWWWW#W#W
W###G###GW
W#W#E####W
WWWWWWWWWW