##########
W#E#WG###W
W#W#W#WW#W
W#WG##GW#W
W#WWWW#W#W
W###G##W#W
WWWWWW#W#W
W#######GW
WPWWWWWWTW
WWWWWWWWWW