WWWWWWWWWW
W#E#WG##TW
W#W#W#WW#W
W#WG##GW#W
W#WWWW#W#W
W##EG##W#W
WWWWWW#W#W
W#######GW
WPWWWWWW#W
WWWWWWWWWW